1   1   145 1   1   1   1   1   1   1   1   1   1   1   1   1   
1   1   145 1   12  146 146 14  1   1   1   1   1   1   1   1   
1   1   145 1   145 1   1   36  146 146 146 146 14  1   1   1   
1   1   145 12  38  1   1   1   1   1   1   1   36  146 14  1   
1   1   36  38  1   1   12  14  1   1   1   1   1   1   145 1   
1   1   1   1   1   12  38  36  14  1   1   12  14  1   24  13  
1   1   1   1   12  38  1   1   36  14  12  38  36  146 37  37  
1   1   1   12  38  1   1   1   1   36  38  1   1   1   1   1   
1   1   12  38  1   1   1   1   1   1   1   1   1   1   1   1   

0   1   2   3   4   5   6   7   8   9   10  11  12  13  14  15