1   1   1   1   1   1   1   1   1   1   1   1   1   1   1   1   
1   1   1   1   1   1   1   1   1   1   1   1   1   1   1   1   
133 133 133 133 133 135 1   1   1   12  13  13  13  13  14  1   
1   1   1   1   1   134 1   1   1   24  25  37  37  25  26  1    
1   1   1   1   1   134 1   1   1   24  26  1   1   24  26  1  
1   1   1   1   1   143 13  13  13  39  26  1   1   24  25  13  
1   1   1   1   1   36  141 37  37  37  38  1   1   36  37  37   
1   1   1   1   1   1   134 1   1   1   1   1   1   1   1   1   
1   1   1   1   1   1   134 1   1   1   1   1   1   1   1   1   

0   1   2   3   4   5   6   7   8   9   10  11  12  13  14  15