63 96 79 94 66 66 49 28 60 111 79 58 115 71 44 84 
87 87 96 2 69 95 108 75 91 42 101 125 59 13 82 129 
109 30 99 45 97 18 80 26 5 28 85 120 107 5 80 70 
99 52 72 45 17 57 120 115 99 91 110 34 111 68 40 89 
99 8 10 72 33 91 105 39 126 66 28 109 71 116 49 47 
37 121 99 54 54 88 46 29 55 25 71 35 93 111 1 68 
126 11 16 29 109 122 68 112 57 103 90 5 88 8 59 126 
6 27 56 67 115 102 97 47 3 37 89 97 24 90 41 19 
109 58 48 94 56 116 75 113 96 42 125 53 50 53 48 63 
