1  1  1  1  1  1  1  1  1  1  1  1  1  1  1  1 
13 13 13 13 13 13 14 1  1  1  1  1  1  1  1  1 
37 37 37 37 37 25 26 1  1  12 13 13 13 13 14 1 
1  1  1  1  1  24 26 1  1  24 25 37 37 25 26 1 
1  1  12 13 13 25 26 1  1  24 26 1  1  24 26 1 
1  1  24 25 37 37 38 1  1  24 26 1  1  24 25 13
1  1  24 26 1  1  1  1  1  24 26 1  1  36 37 37
1  1  24 25 13 13 13 13 13 25 26 1  1  1  1  1 
1  1  36 37 37 37 37 37 37 37 38 1  1  1  1  1 
