1   1   1   1   1   1   1   1   1   1   1   1   1   1   1   1   
146 146 146 146 14  1   1   1   1   1   1   1   1   1   1   1   
1   1   1   1   36  146 146 146 146 146 146 14  1   1   1   1   
1   1   1   1   1   1   1   1   1   1   1   145 1   1   1   1    
1   1   1   1   1   12  146 146 146 14  1   145 1   1   1   1  
1   1   1   1   1   145 1   1   1   145 1   24  13  13  13  13  
146 146 146 146 146 38  1   1   1   145 1   24  37  37  37  37   
1   1   1   1   1   1   1   1   1   36  146 38  1   1   1   1   
1   1   1   1   1   1   1   1   1   1   1   1   1   1   1   1   

